;Bezeichnung Auftragskonto;IBAN Auftragskonto;BIC Auftragskonto;Bankname Auftragskonto;Name Zahlungsbeteiligter;IBAN Zahlungsbeteiligter;BIC (SWIFT-Code) Zahlungsbeteiligter;Verwendungszweck;Buchungstag;Valutadatum;Betrag;Buchungstext;Waehrung;Bemerkung;Kategorie;Steuerrelevant;Glaeubiger ID;Mandatsreferenz;Saldo nach Buchung
0;Girokonto;GB87YODA19011530005979;OECF10873187191890;RBPN;Andrew Myers;GB25CZXL23186024805804;XQAB67042397904377;Tree red present pick paper.;2024-01-01;2024-01-01;-184.81;DAUERAUFTRAG;EUR;;;;;;29815.19
1;Girokonto;GB87YODA19011530005979;OECF10873187191890;RBPN;Key Inc;GB04OMVY00591295169235;GTAD63500292776038;Produce foreign expert attorney rise American.;2024-01-05;2024-01-05;-379.7;ABSCHLUSS;EUR;;;;;;29435.49
2;Girokonto;GB87YODA19011530005979;OECF10873187191890;RBPN;Lisa Hill;GB98JUUX14258051007884;AZBD75325200718314;Imagine cut safe color process on be.;2024-01-07;2024-01-07;-147.26;DAUERAUFTRAG;EUR;;;;;;29288.23
3;Girokonto;GB87YODA19011530005979;OECF10873187191890;RBPN;Ashley Stewart;GB30LIPU43896807588812;VWNK21811988757283;Recent stand wrong interest authority character.;2024-01-07;2024-01-07;-228.55;LASTSCHRIFT;EUR;;;;;;29059.68
4;Girokonto;GB87YODA19011530005979;OECF10873187191890;RBPN;Jennifer Roberson;GB86SRTT70515609915393;LQWY69700714652730;Main out loss lose knowledge room save.;2024-01-11;2024-01-11;-59.81;DAUERAUFTRAG;EUR;;;;;;28999.87
5;Girokonto;GB87YODA19011530005979;OECF10873187191890;RBPN;Jennifer Mcclain;GB79JXDO19499572398065;KBLS47370071951345;My gun right contain sign.;2024-01-12;2024-01-12;-50.14;ABSCHLUSS;EUR;;;;;;28949.73
6;Girokonto;GB87YODA19011530005979;OECF10873187191890;RBPN;Underwood Ltd;GB45CBNL57260711157942;TEEG64089898663375;Value learn cold final.;2024-01-13;2024-01-13;2294.68;LOHN/GEHALT;EUR;;;;;;31244.41
7;Girokonto;GB87YODA19011530005979;OECF10873187191890;RBPN;Johnson, Armstrong and Rogers;GB90RKXG18314011048959;VUNT06713155565102;Inside fire my.;2024-01-18;2024-01-18;-195.02;DAUERAUFTRAG;EUR;;;;;;31049.39
8;Girokonto;GB87YODA19011530005979;OECF10873187191890;RBPN;Roberts-Ross;GB79EJSS49633693485532;KIGQ34919970136095;Health first health I walk.;2024-01-19;2024-01-19;-246.03;ABSCHLUSS;EUR;;;;;;30803.36
9;Girokonto;GB87YODA19011530005979;OECF10873187191890;RBPN;Hurley, Daniels and Cruz;GB27CFGN20507642731285;HXRS62517348529090;Out with focus star stay story threat.;2024-01-19;2024-01-19;-19.38;LASTSCHRIFT;EUR;;;;;;30783.98
10;Girokonto;GB87YODA19011530005979;OECF10873187191890;RBPN;Harvey-Booth;GB51CSXN95890678261885;USQR38161582159741;Tv among maybe pull.;2024-01-22;2024-01-22;-115.36;ABSCHLUSS;EUR;;;;;;30668.62
11;Girokonto;GB87YODA19011530005979;OECF10873187191890;RBPN;Adams, Walker and Jones;GB60DSOV30707801799689;HBVF27148426584797;Drive question we follow.;2024-01-24;2024-01-24;-71.81;ABSCHLUSS;EUR;;;;;;30596.81
12;Girokonto;GB87YODA19011530005979;OECF10873187191890;RBPN;Emily Powell;GB63NVJI92795382069792;HMJL69435875128426;Themselves Congress much similar appear drop.;2024-01-24;2024-01-24;-127.53;DAUERAUFTRAG;EUR;;;;;;30469.28
13;Girokonto;GB87YODA19011530005979;OECF10873187191890;RBPN;Teresa Garcia;GB67IUGL12942571163040;HQCZ54719416316378;Line catch answer close certain national research.;2024-01-28;2024-01-28;-351.81;DAUERAUFTRAG;EUR;;;;;;30117.47
14;Girokonto;GB87YODA19011530005979;OECF10873187191890;RBPN;Andrew Myers;GB25CZXL23186024805804;XQAB67042397904377;Tree red present pick paper.;2024-02-01;2024-02-01;-184.81;DAUERAUFTRAG;EUR;;;;;;29932.66
15;Girokonto;GB87YODA19011530005979;OECF10873187191890;RBPN;Taylor-Douglas;GB15CCXJ62429302228692;NUPF98015442717803;Baby nature already including seat.;2024-02-01;2024-02-01;-107.69;Kartenzahlung V PAY;EUR;;;;;;29824.97
16;Girokonto;GB87YODA19011530005979;OECF10873187191890;RBPN;Key Inc;GB04OMVY00591295169235;GTAD63500292776038;Produce foreign expert attorney rise American.;2024-02-05;2024-02-05;-379.7;ABSCHLUSS;EUR;;;;;;29445.27
17;Girokonto;GB87YODA19011530005979;OECF10873187191890;RBPN;Lisa Hill;GB98JUUX14258051007884;AZBD75325200718314;Imagine cut safe color process on be.;2024-02-07;2024-02-07;-147.26;DAUERAUFTRAG;EUR;;;;;;29298.01
18;Girokonto;GB87YODA19011530005979;OECF10873187191890;RBPN;Jones, Evans and Duran;GB67ESML46381310928833;QVIC23874398105986;Within official could seek beautiful.;2024-02-10;2024-02-10;-154.89;SEPA-UEBERWEISUNG;EUR;;;;;;29143.12
19;Girokonto;GB87YODA19011530005979;OECF10873187191890;RBPN;Jennifer Roberson;GB86SRTT70515609915393;LQWY69700714652730;Main out loss lose knowledge room save.;2024-02-11;2024-02-11;-59.81;DAUERAUFTRAG;EUR;;;;;;29083.31
20;Girokonto;GB87YODA19011530005979;OECF10873187191890;RBPN;Jennifer Mcclain;GB79JXDO19499572398065;KBLS47370071951345;My gun right contain sign.;2024-02-12;2024-02-12;-50.14;ABSCHLUSS;EUR;;;;;;29033.17
21;Girokonto;GB87YODA19011530005979;OECF10873187191890;RBPN;Underwood Ltd;GB45CBNL57260711157942;TEEG64089898663375;Value learn cold final.;2024-02-13;2024-02-13;2294.68;LOHN/GEHALT;EUR;;;;;;31327.85
22;Girokonto;GB87YODA19011530005979;OECF10873187191890;RBPN;Johnson, Armstrong and Rogers;GB90RKXG18314011048959;VUNT06713155565102;Inside fire my.;2024-02-18;2024-02-18;-195.02;DAUERAUFTRAG;EUR;;;;;;31132.83
23;Girokonto;GB87YODA19011530005979;OECF10873187191890;RBPN;Roberts-Ross;GB79EJSS49633693485532;KIGQ34919970136095;Health first health I walk.;2024-02-19;2024-02-19;-246.03;ABSCHLUSS;EUR;;;;;;30886.8
24;Girokonto;GB87YODA19011530005979;OECF10873187191890;RBPN;Harvey-Booth;GB51CSXN95890678261885;USQR38161582159741;Tv among maybe pull.;2024-02-22;2024-02-22;-115.36;ABSCHLUSS;EUR;;;;;;30771.44
25;Girokonto;GB87YODA19011530005979;OECF10873187191890;RBPN;Emily Powell;GB63NVJI92795382069792;HMJL69435875128426;Themselves Congress much similar appear drop.;2024-02-24;2024-02-24;-127.53;DAUERAUFTRAG;EUR;;;;;;30643.91
26;Girokonto;GB87YODA19011530005979;OECF10873187191890;RBPN;Adams, Walker and Jones;GB60DSOV30707801799689;HBVF27148426584797;Drive question we follow.;2024-02-24;2024-02-24;-71.81;ABSCHLUSS;EUR;;;;;;30572.1
27;Girokonto;GB87YODA19011530005979;OECF10873187191890;RBPN;Teresa Garcia;GB67IUGL12942571163040;HQCZ54719416316378;Line catch answer close certain national research.;2024-02-28;2024-02-28;-351.81;DAUERAUFTRAG;EUR;;;;;;30220.29
28;Girokonto;GB87YODA19011530005979;OECF10873187191890;RBPN;Andrew Myers;GB25CZXL23186024805804;XQAB67042397904377;Tree red present pick paper.;2024-03-01;2024-03-01;-184.81;DAUERAUFTRAG;EUR;;;;;;30035.48
29;Girokonto;GB87YODA19011530005979;OECF10873187191890;RBPN;Key Inc;GB04OMVY00591295169235;GTAD63500292776038;Produce foreign expert attorney rise American.;2024-03-05;2024-03-05;-379.7;ABSCHLUSS;EUR;;;;;;29655.78
30;Girokonto;GB87YODA19011530005979;OECF10873187191890;RBPN;Lisa Hill;GB98JUUX14258051007884;AZBD75325200718314;Imagine cut safe color process on be.;2024-03-07;2024-03-07;-147.26;DAUERAUFTRAG;EUR;;;;;;29508.52
31;Girokonto;GB87YODA19011530005979;OECF10873187191890;RBPN;Jasmin Delgado;GB19KELZ79791584206109;POMR47764783051201;On bar entire various.;2024-03-07;2024-03-07;-140.62;Kartenzahlung girocard;EUR;;;;;;29367.9
32;Girokonto;GB87YODA19011530005979;OECF10873187191890;RBPN;Jennifer Roberson;GB86SRTT70515609915393;LQWY69700714652730;Main out loss lose knowledge room save.;2024-03-11;2024-03-11;-59.81;DAUERAUFTRAG;EUR;;;;;;29308.09
33;Girokonto;GB87YODA19011530005979;OECF10873187191890;RBPN;Jennifer Mcclain;GB79JXDO19499572398065;KBLS47370071951345;My gun right contain sign.;2024-03-12;2024-03-12;-50.14;ABSCHLUSS;EUR;;;;;;29257.95
34;Girokonto;GB87YODA19011530005979;OECF10873187191890;RBPN;Underwood Ltd;GB45CBNL57260711157942;TEEG64089898663375;Value learn cold final.;2024-03-13;2024-03-13;2294.68;LOHN/GEHALT;EUR;;;;;;31552.63
35;Girokonto;GB87YODA19011530005979;OECF10873187191890;RBPN;Johnson, Armstrong and Rogers;GB90RKXG18314011048959;VUNT06713155565102;Inside fire my.;2024-03-18;2024-03-18;-195.02;DAUERAUFTRAG;EUR;;;;;;31357.61
36;Girokonto;GB87YODA19011530005979;OECF10873187191890;RBPN;Roberts-Ross;GB79EJSS49633693485532;KIGQ34919970136095;Health first health I walk.;2024-03-19;2024-03-19;-246.03;ABSCHLUSS;EUR;;;;;;31111.579999999998
37;Girokonto;GB87YODA19011530005979;OECF10873187191890;RBPN;Harvey-Booth;GB51CSXN95890678261885;USQR38161582159741;Tv among maybe pull.;2024-03-22;2024-03-22;-115.36;ABSCHLUSS;EUR;;;;;;30996.22
38;Girokonto;GB87YODA19011530005979;OECF10873187191890;RBPN;Adams, Walker and Jones;GB60DSOV30707801799689;HBVF27148426584797;Drive question we follow.;2024-03-24;2024-03-24;-71.81;ABSCHLUSS;EUR;;;;;;30924.41
39;Girokonto;GB87YODA19011530005979;OECF10873187191890;RBPN;Emily Powell;GB63NVJI92795382069792;HMJL69435875128426;Themselves Congress much similar appear drop.;2024-03-24;2024-03-24;-127.53;DAUERAUFTRAG;EUR;;;;;;30796.88
40;Girokonto;GB87YODA19011530005979;OECF10873187191890;RBPN;Teresa Garcia;GB67IUGL12942571163040;HQCZ54719416316378;Line catch answer close certain national research.;2024-03-28;2024-03-28;-351.81;DAUERAUFTRAG;EUR;;;;;;30445.07
41;Girokonto;GB87YODA19011530005979;OECF10873187191890;RBPN;Andrew Myers;GB25CZXL23186024805804;XQAB67042397904377;Tree red present pick paper.;2024-04-01;2024-04-01;-184.81;DAUERAUFTRAG;EUR;;;;;;30260.26
42;Girokonto;GB87YODA19011530005979;OECF10873187191890;RBPN;Proctor-Baker;GB09MBPY82015357802342;QBTG89477213155141;Cost read cultural from voice concern city.;2024-04-05;2024-04-05;-256.59;Auszahlung girocard;EUR;;;;;;30003.67
43;Girokonto;GB87YODA19011530005979;OECF10873187191890;RBPN;Key Inc;GB04OMVY00591295169235;GTAD63500292776038;Produce foreign expert attorney rise American.;2024-04-05;2024-04-05;-379.7;ABSCHLUSS;EUR;;;;;;29623.97
44;Girokonto;GB87YODA19011530005979;OECF10873187191890;RBPN;Collins LLC;GB24XUML14456210338092;DNYU78595969064599;Wind hot laugh stand ever way few.;2024-04-06;2024-04-06;-247.26;Auszahlung girocard;EUR;;;;;;29376.71
45;Girokonto;GB87YODA19011530005979;OECF10873187191890;RBPN;Lisa Hill;GB98JUUX14258051007884;AZBD75325200718314;Imagine cut safe color process on be.;2024-04-07;2024-04-07;-147.26;DAUERAUFTRAG;EUR;;;;;;29229.45
46;Girokonto;GB87YODA19011530005979;OECF10873187191890;RBPN;Jennifer Roberson;GB86SRTT70515609915393;LQWY69700714652730;Main out loss lose knowledge room save.;2024-04-11;2024-04-11;-59.81;DAUERAUFTRAG;EUR;;;;;;29169.64
47;Girokonto;GB87YODA19011530005979;OECF10873187191890;RBPN;Jennifer Mcclain;GB79JXDO19499572398065;KBLS47370071951345;My gun right contain sign.;2024-04-12;2024-04-12;-50.14;ABSCHLUSS;EUR;;;;;;29119.5
48;Girokonto;GB87YODA19011530005979;OECF10873187191890;RBPN;Underwood Ltd;GB45CBNL57260711157942;TEEG64089898663375;Value learn cold final.;2024-04-13;2024-04-13;2294.68;LOHN/GEHALT;EUR;;;;;;31414.18
49;Girokonto;GB87YODA19011530005979;OECF10873187191890;RBPN;Johnson, Armstrong and Rogers;GB90RKXG18314011048959;VUNT06713155565102;Inside fire my.;2024-04-18;2024-04-18;-195.02;DAUERAUFTRAG;EUR;;;;;;31219.16
50;Girokonto;GB87YODA19011530005979;OECF10873187191890;RBPN;Roberts-Ross;GB79EJSS49633693485532;KIGQ34919970136095;Health first health I walk.;2024-04-19;2024-04-19;-246.03;ABSCHLUSS;EUR;;;;;;30973.13
51;Girokonto;GB87YODA19011530005979;OECF10873187191890;RBPN;Miller Group;GB49WYRX68655688988967;WMFO11104839527494;Executive production military game management walk here around.;2024-04-21;2024-04-21;-132.42;Auszahlung girocard;EUR;;;;;;30840.71
52;Girokonto;GB87YODA19011530005979;OECF10873187191890;RBPN;Harvey-Booth;GB51CSXN95890678261885;USQR38161582159741;Tv among maybe pull.;2024-04-22;2024-04-22;-115.36;ABSCHLUSS;EUR;;;;;;30725.35
53;Girokonto;GB87YODA19011530005979;OECF10873187191890;RBPN;Adams, Walker and Jones;GB60DSOV30707801799689;HBVF27148426584797;Drive question we follow.;2024-04-24;2024-04-24;-71.81;ABSCHLUSS;EUR;;;;;;30653.54
54;Girokonto;GB87YODA19011530005979;OECF10873187191890;RBPN;Emily Powell;GB63NVJI92795382069792;HMJL69435875128426;Themselves Congress much similar appear drop.;2024-04-24;2024-04-24;-127.53;DAUERAUFTRAG;EUR;;;;;;30526.01
55;Girokonto;GB87YODA19011530005979;OECF10873187191890;RBPN;Karen Myers;GB42DDEE17518013256496;VZJU57315034685874;Spring report carry hotel loss amount according.;2024-04-24;2024-04-24;-134.4;Aufladung Mobilfunkguthaben;EUR;;;;;;30391.61
56;Girokonto;GB87YODA19011530005979;OECF10873187191890;RBPN;Teresa Garcia;GB67IUGL12942571163040;HQCZ54719416316378;Line catch answer close certain national research.;2024-04-28;2024-04-28;-351.81;DAUERAUFTRAG;EUR;;;;;;30039.8
57;Girokonto;GB87YODA19011530005979;OECF10873187191890;RBPN;Andrew Myers;GB25CZXL23186024805804;XQAB67042397904377;Tree red present pick paper.;2024-05-01;2024-05-01;-184.81;DAUERAUFTRAG;EUR;;;;;;29854.989999999998
58;Girokonto;GB87YODA19011530005979;OECF10873187191890;RBPN;Key Inc;GB04OMVY00591295169235;GTAD63500292776038;Produce foreign expert attorney rise American.;2024-05-05;2024-05-05;-379.7;ABSCHLUSS;EUR;;;;;;29475.29
59;Girokonto;GB87YODA19011530005979;OECF10873187191890;RBPN;Lisa Hill;GB98JUUX14258051007884;AZBD75325200718314;Imagine cut safe color process on be.;2024-05-07;2024-05-07;-147.26;DAUERAUFTRAG;EUR;;;;;;29328.03
60;Girokonto;GB87YODA19011530005979;OECF10873187191890;RBPN;Jennifer Roberson;GB86SRTT70515609915393;LQWY69700714652730;Main out loss lose knowledge room save.;2024-05-11;2024-05-11;-59.81;DAUERAUFTRAG;EUR;;;;;;29268.22
61;Girokonto;GB87YODA19011530005979;OECF10873187191890;RBPN;Michelle Rice;GB43ZPPD88243156485683;TPVV75781871132952;Upon resource total coach win across others TV.;2024-05-12;2024-05-12;-147.63;LASTSCHRIFT;EUR;;;;;;29120.59
62;Girokonto;GB87YODA19011530005979;OECF10873187191890;RBPN;Jennifer Mcclain;GB79JXDO19499572398065;KBLS47370071951345;My gun right contain sign.;2024-05-12;2024-05-12;-50.14;ABSCHLUSS;EUR;;;;;;29070.45
63;Girokonto;GB87YODA19011530005979;OECF10873187191890;RBPN;Underwood Ltd;GB45CBNL57260711157942;TEEG64089898663375;Value learn cold final.;2024-05-13;2024-05-13;2294.68;LOHN/GEHALT;EUR;;;;;;31365.13
64;Girokonto;GB87YODA19011530005979;OECF10873187191890;RBPN;Melissa Martin;GB37YCKK98801497857630;ENMZ86495816204608;Huge may cell imagine.;2024-05-17;2024-05-17;-26.83;SEPA-UEBERWEISUNG;EUR;;;;;;31338.3
65;Girokonto;GB87YODA19011530005979;OECF10873187191890;RBPN;Johnson, Armstrong and Rogers;GB90RKXG18314011048959;VUNT06713155565102;Inside fire my.;2024-05-18;2024-05-18;-195.02;DAUERAUFTRAG;EUR;;;;;;31143.28
66;Girokonto;GB87YODA19011530005979;OECF10873187191890;RBPN;Roberts-Ross;GB79EJSS49633693485532;KIGQ34919970136095;Health first health I walk.;2024-05-19;2024-05-19;-246.03;ABSCHLUSS;EUR;;;;;;30897.25
67;Girokonto;GB87YODA19011530005979;OECF10873187191890;RBPN;Morales, Diaz and Wilson;GB61LIJC75634256520100;TCZR64093238272944;According relate morning position half current fact.;2024-05-19;2024-05-19;-369.66;SEPA-UEBERWEISUNG;EUR;;;;;;30527.59
68;Girokonto;GB87YODA19011530005979;OECF10873187191890;RBPN;Chang and Sons;GB76GBNM53648465928144;NMSI81643496057372;Trouble thousand time forward.;2024-05-22;2024-05-22;-74.85;LASTSCHRIFT;EUR;;;;;;30452.739999999998
69;Girokonto;GB87YODA19011530005979;OECF10873187191890;RBPN;Harvey-Booth;GB51CSXN95890678261885;USQR38161582159741;Tv among maybe pull.;2024-05-22;2024-05-22;-115.36;ABSCHLUSS;EUR;;;;;;30337.38
70;Girokonto;GB87YODA19011530005979;OECF10873187191890;RBPN;Emily Powell;GB63NVJI92795382069792;HMJL69435875128426;Themselves Congress much similar appear drop.;2024-05-24;2024-05-24;-127.53;DAUERAUFTRAG;EUR;;;;;;30209.85
71;Girokonto;GB87YODA19011530005979;OECF10873187191890;RBPN;Adams, Walker and Jones;GB60DSOV30707801799689;HBVF27148426584797;Drive question we follow.;2024-05-24;2024-05-24;-71.81;ABSCHLUSS;EUR;;;;;;30138.04
72;Girokonto;GB87YODA19011530005979;OECF10873187191890;RBPN;Louis Baker;GB55BMZC72143693650832;GKQJ55389882409514;Network animal talk simply page.;2024-05-26;2024-05-26;-139.81;Auszahlung girocard;EUR;;;;;;29998.23
73;Girokonto;GB87YODA19011530005979;OECF10873187191890;RBPN;Teresa Garcia;GB67IUGL12942571163040;HQCZ54719416316378;Line catch answer close certain national research.;2024-05-28;2024-05-28;-351.81;DAUERAUFTRAG;EUR;;;;;;29646.42
74;Girokonto;GB87YODA19011530005979;OECF10873187191890;RBPN;Amy Riley;GB50YYFZ33231044832099;JMKX73228672522775;Style grow eight carry carry.;2024-05-30;2024-05-30;-98.71;LASTSCHRIFT;EUR;;;;;;29547.71
75;Girokonto;GB87YODA19011530005979;OECF10873187191890;RBPN;Andrew Myers;GB25CZXL23186024805804;XQAB67042397904377;Tree red present pick paper.;2024-06-01;2024-06-01;-184.81;DAUERAUFTRAG;EUR;;;;;;29362.899999999998
76;Girokonto;GB87YODA19011530005979;OECF10873187191890;RBPN;Arnold-Lawrence;GB89PEAD91436481302063;UJBQ36211206666368;Environment fear either plant.;2024-06-02;2024-06-02;-289.4;Aufladung Mobilfunkguthaben;EUR;;;;;;29073.5
77;Girokonto;GB87YODA19011530005979;OECF10873187191890;RBPN;Moore-Cole;GB11RWNW48047844706091;UGQN35412707232440;Picture firm necessary bill stand federal performance five.;2024-06-05;2024-06-05;2410.75;EINZAHLUNG;EUR;;;;;;31484.25
78;Girokonto;GB87YODA19011530005979;OECF10873187191890;RBPN;Key Inc;GB04OMVY00591295169235;GTAD63500292776038;Produce foreign expert attorney rise American.;2024-06-05;2024-06-05;-379.7;ABSCHLUSS;EUR;;;;;;31104.55
79;Girokonto;GB87YODA19011530005979;OECF10873187191890;RBPN;Lisa Hill;GB98JUUX14258051007884;AZBD75325200718314;Imagine cut safe color process on be.;2024-06-07;2024-06-07;-147.26;DAUERAUFTRAG;EUR;;;;;;30957.29
80;Girokonto;GB87YODA19011530005979;OECF10873187191890;RBPN;Jennifer Roberson;GB86SRTT70515609915393;LQWY69700714652730;Main out loss lose knowledge room save.;2024-06-11;2024-06-11;-59.81;DAUERAUFTRAG;EUR;;;;;;30897.48
81;Girokonto;GB87YODA19011530005979;OECF10873187191890;RBPN;Jennifer Mcclain;GB79JXDO19499572398065;KBLS47370071951345;My gun right contain sign.;2024-06-12;2024-06-12;-50.14;ABSCHLUSS;EUR;;;;;;30847.34
82;Girokonto;GB87YODA19011530005979;OECF10873187191890;RBPN;Underwood Ltd;GB45CBNL57260711157942;TEEG64089898663375;Value learn cold final.;2024-06-13;2024-06-13;2294.68;LOHN/GEHALT;EUR;;;;;;33142.02
83;Girokonto;GB87YODA19011530005979;OECF10873187191890;RBPN;Johnson, Armstrong and Rogers;GB90RKXG18314011048959;VUNT06713155565102;Inside fire my.;2024-06-18;2024-06-18;-195.02;DAUERAUFTRAG;EUR;;;;;;32947.0
84;Girokonto;GB87YODA19011530005979;OECF10873187191890;RBPN;Roberts-Ross;GB79EJSS49633693485532;KIGQ34919970136095;Health first health I walk.;2024-06-19;2024-06-19;-246.03;ABSCHLUSS;EUR;;;;;;32700.97
85;Girokonto;GB87YODA19011530005979;OECF10873187191890;RBPN;Daniel Obrien;GB59UEXD51811170366359;KBBN86737978589594;Water area all bed.;2024-06-21;2024-06-21;-65.78;Aufladung Mobilfunkguthaben;EUR;;;;;;32635.19
86;Girokonto;GB87YODA19011530005979;OECF10873187191890;RBPN;Laura Erickson;GB35PUEM87964944252494;HJFE99704650508039;Whatever place free crime.;2024-06-22;2024-06-22;-231.82;Kartenzahlung V PAY;EUR;;;;;;32403.37
87;Girokonto;GB87YODA19011530005979;OECF10873187191890;RBPN;Harvey-Booth;GB51CSXN95890678261885;USQR38161582159741;Tv among maybe pull.;2024-06-22;2024-06-22;-115.36;ABSCHLUSS;EUR;;;;;;32288.01
88;Girokonto;GB87YODA19011530005979;OECF10873187191890;RBPN;Adams, Walker and Jones;GB60DSOV30707801799689;HBVF27148426584797;Drive question we follow.;2024-06-24;2024-06-24;-71.81;ABSCHLUSS;EUR;;;;;;32216.199999999997
89;Girokonto;GB87YODA19011530005979;OECF10873187191890;RBPN;Emily Powell;GB63NVJI92795382069792;HMJL69435875128426;Themselves Congress much similar appear drop.;2024-06-24;2024-06-24;-127.53;DAUERAUFTRAG;EUR;;;;;;32088.67
90;Girokonto;GB87YODA19011530005979;OECF10873187191890;RBPN;Teresa Garcia;GB67IUGL12942571163040;HQCZ54719416316378;Line catch answer close certain national research.;2024-06-28;2024-06-28;-351.81;DAUERAUFTRAG;EUR;;;;;;31736.86
91;Girokonto;GB87YODA19011530005979;OECF10873187191890;RBPN;Andrew Myers;GB25CZXL23186024805804;XQAB67042397904377;Tree red present pick paper.;2024-07-01;2024-07-01;-184.81;DAUERAUFTRAG;EUR;;;;;;31552.05
92;Girokonto;GB87YODA19011530005979;OECF10873187191890;RBPN;Jeffery Brown;GB83EUFY00900457245511;BSYV75469993902286;Receive visit blue free.;2024-07-01;2024-07-01;-14.51;LASTSCHRIFT;EUR;;;;;;31537.539999999997
93;Girokonto;GB87YODA19011530005979;OECF10873187191890;RBPN;Key Inc;GB04OMVY00591295169235;GTAD63500292776038;Produce foreign expert attorney rise American.;2024-07-05;2024-07-05;-379.7;ABSCHLUSS;EUR;;;;;;31157.84
94;Girokonto;GB87YODA19011530005979;OECF10873187191890;RBPN;Lisa Hill;GB98JUUX14258051007884;AZBD75325200718314;Imagine cut safe color process on be.;2024-07-07;2024-07-07;-147.26;DAUERAUFTRAG;EUR;;;;;;31010.579999999998
95;Girokonto;GB87YODA19011530005979;OECF10873187191890;RBPN;Jennifer Roberson;GB86SRTT70515609915393;LQWY69700714652730;Main out loss lose knowledge room save.;2024-07-11;2024-07-11;-59.81;DAUERAUFTRAG;EUR;;;;;;30950.77
96;Girokonto;GB87YODA19011530005979;OECF10873187191890;RBPN;Parks, Rivera and Bautista;GB51JSGQ41893585574189;SRDH45206003258568;Performance attention most stuff read trial senior.;2024-07-12;2024-07-12;-142.24;Kartenzahlung girocard;EUR;;;;;;30808.53
97;Girokonto;GB87YODA19011530005979;OECF10873187191890;RBPN;Jennifer Mcclain;GB79JXDO19499572398065;KBLS47370071951345;My gun right contain sign.;2024-07-12;2024-07-12;-50.14;ABSCHLUSS;EUR;;;;;;30758.39
98;Girokonto;GB87YODA19011530005979;OECF10873187191890;RBPN;Underwood Ltd;GB45CBNL57260711157942;TEEG64089898663375;Value learn cold final.;2024-07-13;2024-07-13;2294.68;LOHN/GEHALT;EUR;;;;;;33053.07
99;Girokonto;GB87YODA19011530005979;OECF10873187191890;RBPN;Wright-Haley;GB65CCKJ90010174342191;DYYY59054277916717;Those camera green ability task animal chance step.;2024-07-13;2024-07-13;-255.95;Aufladung Mobilfunkguthaben;EUR;;;;;;32797.119999999995
100;Girokonto;GB87YODA19011530005979;OECF10873187191890;RBPN;Johnson, Armstrong and Rogers;GB90RKXG18314011048959;VUNT06713155565102;Inside fire my.;2024-07-18;2024-07-18;-195.02;DAUERAUFTRAG;EUR;;;;;;32602.1
101;Girokonto;GB87YODA19011530005979;OECF10873187191890;RBPN;Roberts-Ross;GB79EJSS49633693485532;KIGQ34919970136095;Health first health I walk.;2024-07-19;2024-07-19;-246.03;ABSCHLUSS;EUR;;;;;;32356.07
102;Girokonto;GB87YODA19011530005979;OECF10873187191890;RBPN;Luis Hicks;GB31DBDB28858397329675;YQRT22209378850329;Movement certainly significant to without I.;2024-07-22;2024-07-22;-260.38;Auszahlung girocard;EUR;;;;;;32095.69
103;Girokonto;GB87YODA19011530005979;OECF10873187191890;RBPN;Harvey-Booth;GB51CSXN95890678261885;USQR38161582159741;Tv among maybe pull.;2024-07-22;2024-07-22;-115.36;ABSCHLUSS;EUR;;;;;;31980.329999999998
104;Girokonto;GB87YODA19011530005979;OECF10873187191890;RBPN;Emily Powell;GB63NVJI92795382069792;HMJL69435875128426;Themselves Congress much similar appear drop.;2024-07-24;2024-07-24;-127.53;DAUERAUFTRAG;EUR;;;;;;31852.8
105;Girokonto;GB87YODA19011530005979;OECF10873187191890;RBPN;Adams, Walker and Jones;GB60DSOV30707801799689;HBVF27148426584797;Drive question we follow.;2024-07-24;2024-07-24;-71.81;ABSCHLUSS;EUR;;;;;;31780.989999999998
106;Girokonto;GB87YODA19011530005979;OECF10873187191890;RBPN;Wyatt-Brock;GB75WWGT82554870870603;DUJF48692471813571;Human brother tree specific.;2024-07-24;2024-07-24;-151.07;SEPA-UEBERWEISUNG;EUR;;;;;;31629.92
107;Girokonto;GB87YODA19011530005979;OECF10873187191890;RBPN;Brian Contreras;GB69OVYM85148454554764;YQVN28684987986273;Man board discover likely study case air.;2024-07-26;2024-07-26;-213.72;Auszahlung girocard;EUR;;;;;;31416.199999999997
108;Girokonto;GB87YODA19011530005979;OECF10873187191890;RBPN;Teresa Garcia;GB67IUGL12942571163040;HQCZ54719416316378;Line catch answer close certain national research.;2024-07-28;2024-07-28;-351.81;DAUERAUFTRAG;EUR;;;;;;31064.39
109;Girokonto;GB87YODA19011530005979;OECF10873187191890;RBPN;Andrew Myers;GB25CZXL23186024805804;XQAB67042397904377;Tree red present pick paper.;2024-08-01;2024-08-01;-184.81;DAUERAUFTRAG;EUR;;;;;;30879.579999999998
110;Girokonto;GB87YODA19011530005979;OECF10873187191890;RBPN;Key Inc;GB04OMVY00591295169235;GTAD63500292776038;Produce foreign expert attorney rise American.;2024-08-05;2024-08-05;-379.7;ABSCHLUSS;EUR;;;;;;30499.879999999997
111;Girokonto;GB87YODA19011530005979;OECF10873187191890;RBPN;Lisa Hill;GB98JUUX14258051007884;AZBD75325200718314;Imagine cut safe color process on be.;2024-08-07;2024-08-07;-147.26;DAUERAUFTRAG;EUR;;;;;;30352.62
112;Girokonto;GB87YODA19011530005979;OECF10873187191890;RBPN;Jennifer Roberson;GB86SRTT70515609915393;LQWY69700714652730;Main out loss lose knowledge room save.;2024-08-11;2024-08-11;-59.81;DAUERAUFTRAG;EUR;;;;;;30292.809999999998
113;Girokonto;GB87YODA19011530005979;OECF10873187191890;RBPN;Jennifer Mcclain;GB79JXDO19499572398065;KBLS47370071951345;My gun right contain sign.;2024-08-12;2024-08-12;-50.14;ABSCHLUSS;EUR;;;;;;30242.67
114;Girokonto;GB87YODA19011530005979;OECF10873187191890;RBPN;Underwood Ltd;GB45CBNL57260711157942;TEEG64089898663375;Value learn cold final.;2024-08-13;2024-08-13;2294.68;LOHN/GEHALT;EUR;;;;;;32537.35
115;Girokonto;GB87YODA19011530005979;OECF10873187191890;RBPN;Theresa Mayo;GB97VVQO95939947263271;TKFL18602408763919;Painting partner protect what good agent street.;2024-08-14;2024-08-14;2702.6;EINZAHLUNG;EUR;;;;;;35239.95
116;Girokonto;GB87YODA19011530005979;OECF10873187191890;RBPN;Elliott, Bowers and Brown;GB19CQLL70000983916488;YHIJ11945567076853;Owner instead week language writer top although physical.;2024-08-15;2024-08-15;-194.92;SEPA-UEBERWEISUNG;EUR;;;;;;35045.03
117;Girokonto;GB87YODA19011530005979;OECF10873187191890;RBPN;Johnson, Armstrong and Rogers;GB90RKXG18314011048959;VUNT06713155565102;Inside fire my.;2024-08-18;2024-08-18;-195.02;DAUERAUFTRAG;EUR;;;;;;34850.009999999995
118;Girokonto;GB87YODA19011530005979;OECF10873187191890;RBPN;Roberts-Ross;GB79EJSS49633693485532;KIGQ34919970136095;Health first health I walk.;2024-08-19;2024-08-19;-246.03;ABSCHLUSS;EUR;;;;;;34603.979999999996
119;Girokonto;GB87YODA19011530005979;OECF10873187191890;RBPN;Horn-Adams;GB14UGOQ08105276201972;CRGE05182470640242;Safe mind just every sing indicate.;2024-08-19;2024-08-19;-362.88;Aufladung Mobilfunkguthaben;EUR;;;;;;34241.1
120;Girokonto;GB87YODA19011530005979;OECF10873187191890;RBPN;Harvey-Booth;GB51CSXN95890678261885;USQR38161582159741;Tv among maybe pull.;2024-08-22;2024-08-22;-115.36;ABSCHLUSS;EUR;;;;;;34125.74
121;Girokonto;GB87YODA19011530005979;OECF10873187191890;RBPN;Emily Powell;GB63NVJI92795382069792;HMJL69435875128426;Themselves Congress much similar appear drop.;2024-08-24;2024-08-24;-127.53;DAUERAUFTRAG;EUR;;;;;;33998.21
122;Girokonto;GB87YODA19011530005979;OECF10873187191890;RBPN;Adams, Walker and Jones;GB60DSOV30707801799689;HBVF27148426584797;Drive question we follow.;2024-08-24;2024-08-24;-71.81;ABSCHLUSS;EUR;;;;;;33926.4
123;Girokonto;GB87YODA19011530005979;OECF10873187191890;RBPN;Teresa Garcia;GB67IUGL12942571163040;HQCZ54719416316378;Line catch answer close certain national research.;2024-08-28;2024-08-28;-351.81;DAUERAUFTRAG;EUR;;;;;;33574.59
124;Girokonto;GB87YODA19011530005979;OECF10873187191890;RBPN;Andrew Myers;GB25CZXL23186024805804;XQAB67042397904377;Tree red present pick paper.;2024-09-01;2024-09-01;-184.81;DAUERAUFTRAG;EUR;;;;;;33389.78
125;Girokonto;GB87YODA19011530005979;OECF10873187191890;RBPN;Key Inc;GB04OMVY00591295169235;GTAD63500292776038;Produce foreign expert attorney rise American.;2024-09-05;2024-09-05;-379.7;ABSCHLUSS;EUR;;;;;;33010.08
126;Girokonto;GB87YODA19011530005979;OECF10873187191890;RBPN;Lisa Hill;GB98JUUX14258051007884;AZBD75325200718314;Imagine cut safe color process on be.;2024-09-07;2024-09-07;-147.26;DAUERAUFTRAG;EUR;;;;;;32862.82
127;Girokonto;GB87YODA19011530005979;OECF10873187191890;RBPN;Matthew Martinez;GB93FHBU69779870102528;EZCP56216993130462;As coach remember rock for step save.;2024-09-09;2024-09-09;-314.36;Kartenzahlung V PAY;EUR;;;;;;32548.46
128;Girokonto;GB87YODA19011530005979;OECF10873187191890;RBPN;Jennifer Roberson;GB86SRTT70515609915393;LQWY69700714652730;Main out loss lose knowledge room save.;2024-09-11;2024-09-11;-59.81;DAUERAUFTRAG;EUR;;;;;;32488.649999999998
129;Girokonto;GB87YODA19011530005979;OECF10873187191890;RBPN;Jennifer Mcclain;GB79JXDO19499572398065;KBLS47370071951345;My gun right contain sign.;2024-09-12;2024-09-12;-50.14;ABSCHLUSS;EUR;;;;;;32438.51
130;Girokonto;GB87YODA19011530005979;OECF10873187191890;RBPN;Underwood Ltd;GB45CBNL57260711157942;TEEG64089898663375;Value learn cold final.;2024-09-13;2024-09-13;2294.68;LOHN/GEHALT;EUR;;;;;;34733.19
131;Girokonto;GB87YODA19011530005979;OECF10873187191890;RBPN;Reyes-Sanders;GB21FVEW59178681441730;KJPQ86196008256159;Major ask ability individual operation.;2024-09-18;2024-09-18;-131.52;Auszahlung girocard;EUR;;;;;;34601.67
132;Girokonto;GB87YODA19011530005979;OECF10873187191890;RBPN;Johnson, Armstrong and Rogers;GB90RKXG18314011048959;VUNT06713155565102;Inside fire my.;2024-09-18;2024-09-18;-195.02;DAUERAUFTRAG;EUR;;;;;;34406.649999999994
133;Girokonto;GB87YODA19011530005979;OECF10873187191890;RBPN;Roberts-Ross;GB79EJSS49633693485532;KIGQ34919970136095;Health first health I walk.;2024-09-19;2024-09-19;-246.03;ABSCHLUSS;EUR;;;;;;34160.619999999995
134;Girokonto;GB87YODA19011530005979;OECF10873187191890;RBPN;Jennifer Morales;GB25PXMA44627469953324;RQSG21326002971591;Tend seat stand community positive sea.;2024-09-22;2024-09-22;-233.89;Kartenzahlung girocard;EUR;;;;;;33926.729999999996
135;Girokonto;GB87YODA19011530005979;OECF10873187191890;RBPN;Harvey-Booth;GB51CSXN95890678261885;USQR38161582159741;Tv among maybe pull.;2024-09-22;2024-09-22;-115.36;ABSCHLUSS;EUR;;;;;;33811.369999999995
136;Girokonto;GB87YODA19011530005979;OECF10873187191890;RBPN;Adams, Walker and Jones;GB60DSOV30707801799689;HBVF27148426584797;Drive question we follow.;2024-09-24;2024-09-24;-71.81;ABSCHLUSS;EUR;;;;;;33739.56
137;Girokonto;GB87YODA19011530005979;OECF10873187191890;RBPN;Emily Powell;GB63NVJI92795382069792;HMJL69435875128426;Themselves Congress much similar appear drop.;2024-09-24;2024-09-24;-127.53;DAUERAUFTRAG;EUR;;;;;;33612.03
138;Girokonto;GB87YODA19011530005979;OECF10873187191890;RBPN;Freeman LLC;GB16TEIY67452173731428;IEMG38823596085338;Type laugh task each.;2024-09-28;2024-09-28;-404.67;LASTSCHRIFT;EUR;;;;;;33207.36
139;Girokonto;GB87YODA19011530005979;OECF10873187191890;RBPN;Teresa Garcia;GB67IUGL12942571163040;HQCZ54719416316378;Line catch answer close certain national research.;2024-09-28;2024-09-28;-351.81;DAUERAUFTRAG;EUR;;;;;;32855.549999999996
140;Girokonto;GB87YODA19011530005979;OECF10873187191890;RBPN;Steven Rivers;GB84DWOE08782474840355;DRWR66037800396361;Bit doctor week build.;2024-09-29;2024-09-29;-159.85;Kartenzahlung V PAY;EUR;;;;;;32695.699999999997
141;Girokonto;GB87YODA19011530005979;OECF10873187191890;RBPN;Andrew Myers;GB25CZXL23186024805804;XQAB67042397904377;Tree red present pick paper.;2024-10-01;2024-10-01;-184.81;DAUERAUFTRAG;EUR;;;;;;32510.89
142;Girokonto;GB87YODA19011530005979;OECF10873187191890;RBPN;Elliott-Riggs;GB20DHUA79287944999345;SYAC64649147287284;Consumer physical if cup child let.;2024-10-02;2024-10-02;-405.59;Auszahlung girocard;EUR;;;;;;32105.3
143;Girokonto;GB87YODA19011530005979;OECF10873187191890;RBPN;Hill-Peters;GB31HDAX33126635998956;VOSB60259400581280;Remain bed answer market.;2024-10-04;2024-10-04;-233.05;Auszahlung girocard;EUR;;;;;;31872.249999999996
144;Girokonto;GB87YODA19011530005979;OECF10873187191890;RBPN;Key Inc;GB04OMVY00591295169235;GTAD63500292776038;Produce foreign expert attorney rise American.;2024-10-05;2024-10-05;-379.7;ABSCHLUSS;EUR;;;;;;31492.55
145;Girokonto;GB87YODA19011530005979;OECF10873187191890;RBPN;Lisa Hill;GB98JUUX14258051007884;AZBD75325200718314;Imagine cut safe color process on be.;2024-10-07;2024-10-07;-147.26;DAUERAUFTRAG;EUR;;;;;;31345.289999999997
146;Girokonto;GB87YODA19011530005979;OECF10873187191890;RBPN;Jennifer Roberson;GB86SRTT70515609915393;LQWY69700714652730;Main out loss lose knowledge room save.;2024-10-11;2024-10-11;-59.81;DAUERAUFTRAG;EUR;;;;;;31285.48
147;Girokonto;GB87YODA19011530005979;OECF10873187191890;RBPN;Jennifer Mcclain;GB79JXDO19499572398065;KBLS47370071951345;My gun right contain sign.;2024-10-12;2024-10-12;-50.14;ABSCHLUSS;EUR;;;;;;31235.339999999997
148;Girokonto;GB87YODA19011530005979;OECF10873187191890;RBPN;Underwood Ltd;GB45CBNL57260711157942;TEEG64089898663375;Value learn cold final.;2024-10-13;2024-10-13;2294.68;LOHN/GEHALT;EUR;;;;;;33530.02
149;Girokonto;GB87YODA19011530005979;OECF10873187191890;RBPN;Johnson, Armstrong and Rogers;GB90RKXG18314011048959;VUNT06713155565102;Inside fire my.;2024-10-18;2024-10-18;-195.02;DAUERAUFTRAG;EUR;;;;;;33335.0
150;Girokonto;GB87YODA19011530005979;OECF10873187191890;RBPN;Roberts-Ross;GB79EJSS49633693485532;KIGQ34919970136095;Health first health I walk.;2024-10-19;2024-10-19;-246.03;ABSCHLUSS;EUR;;;;;;33088.97
151;Girokonto;GB87YODA19011530005979;OECF10873187191890;RBPN;Harvey-Booth;GB51CSXN95890678261885;USQR38161582159741;Tv among maybe pull.;2024-10-22;2024-10-22;-115.36;ABSCHLUSS;EUR;;;;;;32973.61
152;Girokonto;GB87YODA19011530005979;OECF10873187191890;RBPN;Adams, Walker and Jones;GB60DSOV30707801799689;HBVF27148426584797;Drive question we follow.;2024-10-24;2024-10-24;-71.81;ABSCHLUSS;EUR;;;;;;32901.799999999996
153;Girokonto;GB87YODA19011530005979;OECF10873187191890;RBPN;Emily Powell;GB63NVJI92795382069792;HMJL69435875128426;Themselves Congress much similar appear drop.;2024-10-24;2024-10-24;-127.53;DAUERAUFTRAG;EUR;;;;;;32774.27
154;Girokonto;GB87YODA19011530005979;OECF10873187191890;RBPN;Jensen, Howard and Sheppard;GB41UBRP92674376970661;RISY02165589609738;Issue wait economic here east.;2024-10-24;2024-10-24;-114.49;LASTSCHRIFT;EUR;;;;;;32659.78
155;Girokonto;GB87YODA19011530005979;OECF10873187191890;RBPN;Teresa Garcia;GB67IUGL12942571163040;HQCZ54719416316378;Line catch answer close certain national research.;2024-10-28;2024-10-28;-351.81;DAUERAUFTRAG;EUR;;;;;;32307.969999999998
156;Girokonto;GB87YODA19011530005979;OECF10873187191890;RBPN;Andrew Myers;GB25CZXL23186024805804;XQAB67042397904377;Tree red present pick paper.;2024-11-01;2024-11-01;-184.81;DAUERAUFTRAG;EUR;;;;;;32123.159999999996
157;Girokonto;GB87YODA19011530005979;OECF10873187191890;RBPN;Key Inc;GB04OMVY00591295169235;GTAD63500292776038;Produce foreign expert attorney rise American.;2024-11-05;2024-11-05;-379.7;ABSCHLUSS;EUR;;;;;;31743.46
158;Girokonto;GB87YODA19011530005979;OECF10873187191890;RBPN;Lisa Hill;GB98JUUX14258051007884;AZBD75325200718314;Imagine cut safe color process on be.;2024-11-07;2024-11-07;-147.26;DAUERAUFTRAG;EUR;;;;;;31596.199999999997
159;Girokonto;GB87YODA19011530005979;OECF10873187191890;RBPN;Michele Howe;GB28TOTO68584664975342;FNFB39858367086111;Space ago such Congress chair.;2024-11-08;2024-11-08;-26.66;Kartenzahlung girocard;EUR;;;;;;31569.539999999997
160;Girokonto;GB87YODA19011530005979;OECF10873187191890;RBPN;Jennifer Roberson;GB86SRTT70515609915393;LQWY69700714652730;Main out loss lose knowledge room save.;2024-11-11;2024-11-11;-59.81;DAUERAUFTRAG;EUR;;;;;;31509.729999999996
161;Girokonto;GB87YODA19011530005979;OECF10873187191890;RBPN;Jennifer Mcclain;GB79JXDO19499572398065;KBLS47370071951345;My gun right contain sign.;2024-11-12;2024-11-12;-50.14;ABSCHLUSS;EUR;;;;;;31459.589999999997
162;Girokonto;GB87YODA19011530005979;OECF10873187191890;RBPN;Underwood Ltd;GB45CBNL57260711157942;TEEG64089898663375;Value learn cold final.;2024-11-13;2024-11-13;2294.68;LOHN/GEHALT;EUR;;;;;;33754.27
163;Girokonto;GB87YODA19011530005979;OECF10873187191890;RBPN;Johnson, Armstrong and Rogers;GB90RKXG18314011048959;VUNT06713155565102;Inside fire my.;2024-11-18;2024-11-18;-195.02;DAUERAUFTRAG;EUR;;;;;;33559.25
164;Girokonto;GB87YODA19011530005979;OECF10873187191890;RBPN;Roberts-Ross;GB79EJSS49633693485532;KIGQ34919970136095;Health first health I walk.;2024-11-19;2024-11-19;-246.03;ABSCHLUSS;EUR;;;;;;33313.219999999994
165;Girokonto;GB87YODA19011530005979;OECF10873187191890;RBPN;Harvey-Booth;GB51CSXN95890678261885;USQR38161582159741;Tv among maybe pull.;2024-11-22;2024-11-22;-115.36;ABSCHLUSS;EUR;;;;;;33197.86
166;Girokonto;GB87YODA19011530005979;OECF10873187191890;RBPN;Adams, Walker and Jones;GB60DSOV30707801799689;HBVF27148426584797;Drive question we follow.;2024-11-24;2024-11-24;-71.81;ABSCHLUSS;EUR;;;;;;33126.049999999996
167;Girokonto;GB87YODA19011530005979;OECF10873187191890;RBPN;Emily Powell;GB63NVJI92795382069792;HMJL69435875128426;Themselves Congress much similar appear drop.;2024-11-24;2024-11-24;-127.53;DAUERAUFTRAG;EUR;;;;;;32998.52
168;Girokonto;GB87YODA19011530005979;OECF10873187191890;RBPN;Gina Mack;GB81VZJQ81808263462917;THPD61499212884658;Mention simply easy gas both effect technology.;2024-11-25;2024-11-25;-294.47;SEPA-UEBERWEISUNG;EUR;;;;;;32704.049999999996
169;Girokonto;GB87YODA19011530005979;OECF10873187191890;RBPN;Teresa Garcia;GB67IUGL12942571163040;HQCZ54719416316378;Line catch answer close certain national research.;2024-11-28;2024-11-28;-351.81;DAUERAUFTRAG;EUR;;;;;;32352.239999999998
170;Girokonto;GB87YODA19011530005979;OECF10873187191890;RBPN;Andrew Myers;GB25CZXL23186024805804;XQAB67042397904377;Tree red present pick paper.;2024-12-01;2024-12-01;-184.81;DAUERAUFTRAG;EUR;;;;;;32167.429999999997
171;Girokonto;GB87YODA19011530005979;OECF10873187191890;RBPN;Key Inc;GB04OMVY00591295169235;GTAD63500292776038;Produce foreign expert attorney rise American.;2024-12-05;2024-12-05;-379.7;ABSCHLUSS;EUR;;;;;;31787.729999999996
172;Girokonto;GB87YODA19011530005979;OECF10873187191890;RBPN;Lisa Hill;GB98JUUX14258051007884;AZBD75325200718314;Imagine cut safe color process on be.;2024-12-07;2024-12-07;-147.26;DAUERAUFTRAG;EUR;;;;;;31640.469999999998
173;Girokonto;GB87YODA19011530005979;OECF10873187191890;RBPN;Jennifer Roberson;GB86SRTT70515609915393;LQWY69700714652730;Main out loss lose knowledge room save.;2024-12-11;2024-12-11;-59.81;DAUERAUFTRAG;EUR;;;;;;31580.659999999996
174;Girokonto;GB87YODA19011530005979;OECF10873187191890;RBPN;Jennifer Mcclain;GB79JXDO19499572398065;KBLS47370071951345;My gun right contain sign.;2024-12-12;2024-12-12;-50.14;ABSCHLUSS;EUR;;;;;;31530.519999999997
175;Girokonto;GB87YODA19011530005979;OECF10873187191890;RBPN;Underwood Ltd;GB45CBNL57260711157942;TEEG64089898663375;Value learn cold final.;2024-12-13;2024-12-13;2294.68;LOHN/GEHALT;EUR;;;;;;33825.2
176;Girokonto;GB87YODA19011530005979;OECF10873187191890;RBPN;Johnson, Armstrong and Rogers;GB90RKXG18314011048959;VUNT06713155565102;Inside fire my.;2024-12-18;2024-12-18;-195.02;DAUERAUFTRAG;EUR;;;;;;33630.17999999999
177;Girokonto;GB87YODA19011530005979;OECF10873187191890;RBPN;Roberts-Ross;GB79EJSS49633693485532;KIGQ34919970136095;Health first health I walk.;2024-12-19;2024-12-19;-246.03;ABSCHLUSS;EUR;;;;;;33384.149999999994
178;Girokonto;GB87YODA19011530005979;OECF10873187191890;RBPN;Harvey-Booth;GB51CSXN95890678261885;USQR38161582159741;Tv among maybe pull.;2024-12-22;2024-12-22;-115.36;ABSCHLUSS;EUR;;;;;;33268.78999999999
179;Girokonto;GB87YODA19011530005979;OECF10873187191890;RBPN;Emily Powell;GB63NVJI92795382069792;HMJL69435875128426;Themselves Congress much similar appear drop.;2024-12-24;2024-12-24;-127.53;DAUERAUFTRAG;EUR;;;;;;33141.259999999995
180;Girokonto;GB87YODA19011530005979;OECF10873187191890;RBPN;Adams, Walker and Jones;GB60DSOV30707801799689;HBVF27148426584797;Drive question we follow.;2024-12-24;2024-12-24;-71.81;ABSCHLUSS;EUR;;;;;;33069.45
181;Girokonto;GB87YODA19011530005979;OECF10873187191890;RBPN;Teresa Garcia;GB67IUGL12942571163040;HQCZ54719416316378;Line catch answer close certain national research.;2024-12-28;2024-12-28;-351.81;DAUERAUFTRAG;EUR;;;;;;32717.639999999996
